WWWWWWWWWWWWWWWWWWWWWWWWWWWWWWWWWWWWWWWWWWWWWWWWWWWWWWWWWW
WWWWWWWWWWWWWWWWWWWWWWWWWWWWWWWWWWWWWWWWWWWWWWWWWWWWWWWWWW
WWPPPPPPPPPPPPPPPPWWWPPPPPPPPAPPPPPPPWWWPPPPPPPPPPPPPPPPWW
WWPGPPPPPPPPPPPPPPWWWPPPAPPPPPPPPPPPPWWWPPPPPPPPPPPPPPPPWW
WWPPPPGPPPPDPPPPPPWWWPPPPPPPPPPPPPPPPWWWPPPPPAPPPPPPPPPPWW
WWPPPPPPPPPPPPPPPPWWWPPPPPPPAPPPAPPPPWWWPPPPPPPPPPAPPPPPWW
WWPGPPPPPPPPPPPDPPWWWPPPPPPPPPPPPPPPPBBBPPPPPPPPPPPPPPPPWW
WWPPPPPPPPPPPPPPPPWWWPPPPPPPPPPPPPPPPBBBPPPPPPPPPPPPPAPPWW
WWPPPPPPPPPPPPPPPPWWWPPPPPPPPPPPPPPPPBBBPPPPPPPPPPPPPPPPWW
WWPPPPPPPPPPPAPPPPWWWPPPPPPPPPPPDPPPPBBBPPPPPPPPPPAPPPPPWW
WWPPPPPPPPPPPPPPPPBBBPPPPPPDPPPPPPPPPWWWPPPPPPPPPPPPPPPPWW
WWPPPPPPPPPPPPPPPPBBBPPPPPPPPPPPPPPPPWWWPPGPPPPPPPPPPPPPWW
WWPPPPPPPPPPPPPPPPBBBPPPPPPPPPPPPPPPPWWWPPPPPPPPPPPPPPPPWW
WWPPPPPPPPPPPPPPPPBBBPPPPPPPPPPDPPGPPWWWPPPPPPGPPPPPPPPPWW
WWPPPPPPPPPPPPPPPPWWWPPPPPPPPPPPPPPPPWWWPPPGPPPPPPPPPPPPWW
WWPPPPPPPPPPPPPPPPWWWPPGPPPPPPPPPPPPPWWWPPPPPPPPPPPPPPPPWW
WWPPPPPPPPPPPPPPPPWWWPPPPPPPPPPPGPPDPWWWPPPPPPPPPPPPPPPPWW
WWPPPPPPPPPPPPPPPPWWWPPPPPPPPPPPPPPPPWWWPPPPPPPPPPPPPPPPWW
WWPPPPPPPPPPPPPPPPWWWWWWWWWBBBBWWWWWWWWWPPPPPPPPPPPPPPPPWW
WWPPPPPPPPPPPPPPPPWWWWWWWWWBBBBWWWWWWWWWPPPPPPPPPPPPPPPPWW
WWPPPPPPGPPPPPPPPPWWWWWWWWWBBBBWWWWWWWWWPPPPPPPPPGPPPPPPWW
WWPPPPPPPPPPPPPPPPWWWWWWGPPPPPPPPPWWWWWWPPPPPPPPPPPPPPPPWW
WWPPPPPPPPPPPPPPPPWWWWWWPPPPPPPKPPWWWWWWPPPPPPPPPPPPPPPPWW
WWPSPPPPPPPPPPPPPPWWWWWWPPPKPPPPPPWWWWWWPPPPPPPPPPPPPPSPWW
WWPSPPPPPPPPPPPPPPWWWWWWAPPPPPPPPAWWWWWWPPPPPPPPPPPPPPSPWW
WWPSPPPPPPPPPPPPPPWWWWWWPPPPPPKPPPWWWWWWPPPPPPPPPPPPPPSPWW
WWPPPPPPPPPPPPPPPPWWWWWWPPKPPPPPPPWWWWWWPPPPPPPPPPPPPPPPWW
WWPPPPPPPPPPPPPPPPWWWWWWPPPPPPPPPGWWWWWWPPPPPPPPPPPPPPPPWW
WWPPPPPPGPPPPPPPPPWWWWWWWWWBBBBWWWWWWWWWPPPPPPPPPGPPPPPPWW
WWPPPPPPPPPPPPPPPPWWWWWWWWWBBBBWWWWWWWWWPPPPPPPPPPPPPPPPWW
WWPPPPPPPPPPPPPPPPWWWWWWWWWBBBBWWWWWWWWWPPPPPPPPPPPPPPPPWW
WWPPPPPPPPPPPPPPPPWWWPPPPPPPPPPPPPPPPWWWPPPPPPPPPPPPPPPPWW
WWPPPPPPPPPPPPPPPPWWWPDPPGPPPPPPPPPPPWWWPPPPPPPPPPPPPPPPWW
WWPPPPPPPPPPPPPPPPWWWPPPPPPPPPPPPPGPPWWWPPPPPPPPPPPPPPPPWW
WWPPPPPPPPPPPPGPPPWWWPPPPPPPPPPPPPPPPWWWPPPPPPPPPPPPPPPPWW
WWPPPPPPPPPGPPPPPPWWWPPGPPDPPPPPPPPPPBBBPPPPPPPPPPPPPPPPWW
WWPPPPPPPPPPPPPPPPWWWPPPPPPPPPPPPPPPPBBBPPPPPPPPPPPPPPPPWW
WWPPPPPPPPPPPPPGPPWWWPPPPPPPPPPPPPPPPBBBPPPPPPPPPPPPPPPPWW
WWPPPPPPPPPPPPPPPPWWWPPPPPPPPPDPPPPPPBBBPPPPPPPPPPPPPPPPWW
WWPPPPPAPPPPPPPPPPBBBPPPPDPPPPPPPPPPPWWWPPPPAPPPPPPPPPPPWW
WWPPPPPPPPPPPPPPPPBBBPPPPPPPPPPPPPPPPWWWPPPPPPPPPPPPPPPPWW
WWPPAPPPPPPPPPPPPPBBBPPPPPPPPPPPPPPPPWWWPPPPPPPPPPPPPPPPWW
WWPPPPPPPPPPPPPPPPBBBPPPPPPPPPPPPPPPPWWWPPDPPPPPPPPPPPGPWW
WWPPPPPAPPPPPPPPPPWWWPPPPAPPPAPPPPPPPWWWPPPPPPPPPPPPPPPPWW
WWPPPPPPPPPPAPPPPPWWWPPPPPPPPPPPPPPPPWWWPPPPPPDPPPPGPPPPWW
WWPPPPPPPPPPPPPPPPWWWPPPPPPPPPPPPAPPPWWWPPPPPPPPPPPPPPGPWW
WWPPPPPPPPPPPPPPPPWWWPPPPPPPAPPPPPPPPWWWPPPPPPPPPPPPPPPPWW
WWWWWWWWWWWWWWWWWWWWWWWWWWWWWWWWWWWWWWWWWWWWWWWWWWWWWWWWWW
WWWWWWWWWWWWWWWWWWWWWWWWWWWWWWWWWWWWWWWWWWWWWWWWWWWWWWWWWW
